C 200, 100, 1
NO ./include/maps/xpm/NORTH.xpm
SO ./include/maps/xpm/SOUTH.xpm
EA ./include/maps/xpm/EAST.xpm
WE ./include/maps/xpm/WEST.xpm
F 200, 254, 12

111111111111111111111111111111111111111111111111
10E000000000000000000000000010000000000000000001
111111111111100111111111111010000000000000000001
100000000000000000000000000010000000000000000001
100000000000000000000000000010000000000000000001
100000000000000000000000000000000000000000000001
100000000000000000000000000000000000000000000001
100000000000000000000000000000000000000000000001
100000000000000000000000000000000000000000000001
100000000000000000000000000000000000000000000001
100000000000000000000000000000000000000000000001
100000000000000000000000000000000000000000000001
100000000000000000000000000000000000000000000001
100000000000000000000000000000000000000000000001
100000000000000000000000000000000000000000000001
100000000000000000000000000000000000000000000001
111111111111111111111111111111111111111111111111
