NO ./include/maps/xpm/1.xpm
SO ./include/maps/xpm/2.xpm
EA ./include/maps/xpm/3.xpm
WE ./include/maps/xpm/4.xpm

C 255, 255, 255
F 7, 235, 55

111111111111111
100000000000001
100000000S0000111111111
10000001110000000000001
11100001010000111111111
  1000010100011
11100111011101
10000100000101
10000111011101     111111111
1110000001111111111100000001
1111111111         111111111