NO ./include/maps/xpm/9.xpm
SO ./include/maps/xpm/6.xpm
EA ./include/maps/xpm/7.xpm
WE ./include/maps/xpm/8.xpm

C 0, 0, 0
F 5, 5, 5

111111111111111111111
100000000000000000001
100000000000000000001
100001000000000000001
100000100000000000001
100000010000000000001
100000001000000000001
1000000000E0000000001
100000000000000000001
100000000000000000001
100000000001110000001
100000000000000000001
100000000000010000001
100000000000000000001
111111111111111111111